アビシニアン			あびしにあん
アメリカンカール			あめりかんかーる
アメリカンショートヘア			あめりかんしょーとへあ
アメリカンボブテイル			あめりかんぼぶている
アメリカンワイヤーヘア			あめりかんわいやーへあ
エキゾチックショートヘア			えきぞちっくしょーとへあ
エジプシャンマウ			えじぷしゃんまう
オシキャット			おしきゃっと
オリエンタル			おりえんたる
キムリック			きむりっく
コーニッシュレックス			こーにっしゅれっくす
コラット			こらっと
サイベリアン			さいべりあん
ジャパニーズボブテイル			じゃぱにーずぼぶている
シャム			しゃむ
シャルトリュー			しゃるとりゅー
シンガプーラ			しんがぷーら
スコティッシュフォールド			すこてぃっしゅふぉーるど
スノーシュー			すのーしゅー
スフィンクス			すふぃんくす
セルカークレックス			せるかーくれっくす
ソマリ			そまり
ターキッシュアンゴラ			たーきっしゅあんごら
ターキッシュバン			たーきっしゅばん
デボンレックス			でぼんれっくす
トンキニーズ			とんきにーず
ノルウェージャンフォレストキャット			のるうぇーじゃんふぉれすときゃっと
バーマン			ばーまん
ハバナブラウン			はばなぶらうん
バーミーズ			ばーみーず
バリニーズ			ばりにーず
ピクシーボブ			ぴくしーぼぶ
ヒマラヤン			ひまらやん
ブリティッシュショートヘア			ぶりてぃっしゅしょーとへあ
ペルシャ			ぺるしゃ
ベンガル			べんがる
ボンベイ			ぼんべい
マンクス			まんくす
マンチカン			まんちかん
メインクーン			めいんくーん
ラガマフィン			らがまふぃん
ラグドール			らぐどーる
ラパーマ			らぱーま
ロシアンブルー			ろしあんぶるー
アメリカンキューダ			あめりかんきゅーだ
アメリカンポリダクティル			あめりかんぽりだくてぃる
アメリカンリングテイル			あめりかんりんぐている
アラビアンマウ			あらびあんまう
アルパインリンクス			あるぱいんりんくす
イジアン			いじあん
ウラルレックス			うらるれっくす
エイジアン			えいじあん
オイイーボブ			おいいーぼぶ
オーストラリアンミスト			おーすとらりあんみすと
オホサスレス			おほさすれす
オリエンタルバイカラー			おりえんたるばいからー
カラーポイントショートヘアー			からーぽいんとしょーとへあー
カリフォルニアスパングルド			かりふぉるにあすぱんぐるど
ミケネコ			みけねこ
クロネコ			くろねこ
シロネコ			しろねこ
ブチネコ			ぶちねこ
トラネコ			とらねこ
キジトラ			きじとら
サバトラ			さばとら
チャトラ			ちゃとら
サビネコ			さびねこ
キプロスアフロディーテ			きぷろすあふろでぃーて
キンカロー			きんかろー
クリッパーキャット			くりっぱーきゃっと
クリリアンボブテイル			くりりあんぼぶている
サバンナ			さばんな
サファリ			さふぁり
ジャーマンレックス			じゃーまんれっくす
ジェネッタ			じぇねった
シャンティリー			しゃんてぃりー
スクークム			すくーくむ
セイシェルワ			せいしぇるわ
セイロンキャット			せいろんきゃっと
セレンゲティ			せれんげてぃ
ソコケ			そこけ
チートー			ちーとー
チャウシー			ちゃうしー
デザートリンクス			でざーとりんくす
テネシーレックス			てねしーれっくす
トイガー			といがー
トイボブ			といぼぶ
ドウェルフ			どうぇるふ
ドラゴンリー			どらごんりー
ドンスコイ			どんすこい
ナポレオン			なぽれおん
ネベロング			ねべろんぐ
バーレイニディルムンキャット			ばーれいにでぃるむんきゃっと
ハイランドリンクス			はいらんどりんくす
ハバリ			はばり
バンビーノ			ばんびーの
ピーターボールド			ぴーたーぼーるど
フォールデックス			ふぉーるでっくす
ブラジリアンショートヘアー			ぶらじりあんしょーとへあー
ブランブル			ぶらんぶる
ブリティッシュロングヘアー			ぶりてぃっしゅろんぐへあー
マンダレイ			まんだれい
ミンスキン			みんすきん
メコンボブテイル			めこんぼぶている
モハーベスポッテド			もはーべすぽってど
モハーベボブ			もはーべぼぶ
ユークレイニアンレフコイ			ゆーくれいにあんれふこい
ヨークチョコレート			よーくちょこれーと
ヨーロピアンショートヘアー			よーろぴあんしょーとへあー
ライコイ			らいこい
ラムキン			らむきん
