カゼノタニノナウシカ	カゼノタニノナウシカ
テンクウノシロラピュタ	てんくうのしろらぴゅた
トナリノトトロ	となりのととろ
ホタルノハカ	ほたるのはか
マジョノタッキュウビン	まじょのたっきゅうびん
オモヒデポロポロ	おもひでぽろぽろ
クレナイノブタ	くれないのぶた
ウミガキコエル	うみがきこえる
ヘイセイタヌキガッセンポンポコ	へいせいたぬきがっせんぽんぽこ
ミミヲスマセバ	みみをすませば
モノノケヒメ	もののけひめ
ホーホケキョトナリノヤマダクン	ほーほけきょとなりのやまだくん
セントチヒロノカミカクシ	せんとちひろのかみかくし
ネコノオンガエシ	ねこのおんがえし
ハウルノウゴクシロ	はうるのうごくしろ
ゲドセンキ	げどせんき
ガケノウエノポニョ	がけのうえのぽにょ
カリグラシノアリエッティ	かりぐらしのありえってぃ
コクリコザカカラ	こくりこざかから
カゼタチヌ	かぜたちぬ
カグヤヒメノモノガタリ	かぐやひめのものがたり
オモイデノマーニー	おもいでのまーにー
レッドタートル　アルシマノモノガタリ	れっどたーとる　あるしまのものがたり
アーヤトマジョ	あーやとまじょ
