アイチケン		あいちけん
アオモリケン		あおもりけん
アキタケン		あきたけん
イシカワケン		いしかわけん
イバラキケン		いばらきけん
イワテケン		いわてけん
エヒメケン		えひめけん
オオイタケン		おおいたけん
オオサカフ		おおさかふ
オカヤマケン		おかやまけん
オキナワケン		おきなわけん
カガワケン		かがわけん
カゴシマケン		かごしまけん
カナガワケン		かながわけん
ギフケン		ぎふけん
キョウトフ		きょうとふ
クマモトケン		くまもとけん
グンマケン		ぐんまけん
コウチケン		こうちけん
サイタマケン		さいたまけん
サガケン		さがけん
シガケン		しがけん
シズオカケン		しずおかけん
シマネケン		しまねけん
チバケン		ちばけん
トウキョウト		とうきょうと
トクシマケン		とくしまけん
トチギケン		とちぎけん
トットリケン		とっとりけん
トヤマケン		とやまけん
ナガサキケン		ながさきけん
ナガノケン		ながのけん
ナラケン		ならけん
ニイガタケン		にいがたけん
ヒョウゴケン		ひょうごけん
ヒロシマケン		ひろしまけん
フクイケン		ふくいけん
フクオカケン		ふくおかけん
フクシマケン		ふくしまけん
ホッカイドウ		ほっかいどう
ミエケン		みえけん
ミヤギケン		みやぎけん
ミヤザキケン		みやざきけん
ヤマガタケン		やまがたけん
ヤマグチケン		やまぐちけん
ヤマナシケン		やまなしけん
ワカヤマケン		わかやまけん
